g g d d d d d g d d d g g d d g
g g g g g g g g g g g g g g g g
d g d d g g d d d d g d d d d d
g g d d g d d g d d d g g d d g
d g g d g g H B d d g d d d d d
g g d B g d d g d B d g g d d g
d g d d B g d d B d g d g g g g
g g d d g B B B d d d g g d d g
g g g g g g g g g g g g g d d d
g g d d d d d E d d d g g d d g
d g d d g g d d d d g d d d d d
g g d d d d d g d d d g g d d g
d g d d g g d d d d g d d d d d
g g d d d d d g d d d g g d d g
d g d d g g d d d d g d d d d d
g g d d d d d g d d d g g d d g