g g d d d d d g d d d g g d d g 
t t t t t t t t t t t t t t t t
d g d d p g d d d d g d d d d d
g g d d p d d g d d d g g d d g
d g H d p g d d d d g d d d d d
g g d d p d d g d d d g g d d g
d g d d p g d B d d g d t t t t
g g d d p d d g d d d g t d d g
t t t t t p p p p p p p t d d d
g g d d d d d g d d d g B d d g
d E d d g g d d d d g d d d d d
g g d d d d d g d d d g g d d g 
d g d S g g d d d d g d d d d d
g g d d d d d g d d d g g d d g 
d g d d g g d d d d g d d d d d
g g d d d d d g d d d g g d d g 